EUR	DROŻEJE
GBP	DROŻEJE
AUD	TANIEJE
CAD	DROŻEJE
JPY	DROŻEJE
CHF	DROŻEJE
KMF	DROŻEJE
AFN	TANIEJE
ALL	TANIEJE
DZD	DROŻEJE
AOA	TANIEJE
ARS	DROŻEJE
AMD	TANIEJE
AWG	TANIEJE
AZN	TANIEJE
BSD	TANIEJE
BHD	TANIEJE
BDT	TANIEJE
BBD	TANIEJE
BYN	DROŻEJE
BZD	TANIEJE
BOB	TANIEJE
BAM	TANIEJE
BWP	TANIEJE
BRL	TANIEJE
BND	TANIEJE
BGN	DROŻEJE
BIF	DROŻEJE
KHR	TANIEJE
CVE	TANIEJE
XAF	TANIEJE
XPF	TANIEJE
CLP	TANIEJE
CNY	DROŻEJE
COP	TANIEJE
CDF	TANIEJE
CRC	TANIEJE
HRK	TANIEJE
CUP	TANIEJE
CZK	TANIEJE
DKK	DROŻEJE
DJF	TANIEJE
DOP	TANIEJE
XCD	TANIEJE
EGP	TANIEJE
ERN	TANIEJE
ETB	TANIEJE
FJD	DROŻEJE
GMD	TANIEJE
GEL	TANIEJE
GHS	DROŻEJE
GIP	TANIEJE
GTQ	TANIEJE
GNF	TANIEJE
GYD	TANIEJE
HTG	DROŻEJE
HNL	TANIEJE
HKD	TANIEJE
HUF	TANIEJE
ISK	TANIEJE
INR	DROŻEJE
IDR	TANIEJE
IRR	TANIEJE
IQD	TANIEJE
ILS	TANIEJE
JMD	DROŻEJE
JOD	TANIEJE
KZT	TANIEJE
KES	TANIEJE
KWD	DROŻEJE
KGS	TANIEJE
LAK	DROŻEJE
LBP	TANIEJE
LSL	TANIEJE
LRD	DROŻEJE
LYD	DROŻEJE
MOP	TANIEJE
MKD	TANIEJE
MGA	DROŻEJE
MWK	TANIEJE
MYR	DROŻEJE
MVR	TANIEJE
MRU	DROŻEJE
MUR	TANIEJE
MXN	TANIEJE
MDL	TANIEJE
MNT	DROŻEJE
MAD	TANIEJE
MZN	DROŻEJE
MMK	DROŻEJE
NAD	TANIEJE
NPR	DROŻEJE
ANG	TANIEJE
TWD	DROŻEJE
TMT	TANIEJE
NZD	TANIEJE
NIO	DROŻEJE
NGN	DROŻEJE
NOK	TANIEJE
OMR	TANIEJE
PKR	DROŻEJE
PAB	TANIEJE
PGK	DROŻEJE
PYG	DROŻEJE
PEN	TANIEJE
PHP	DROŻEJE
PLN	TANIEJE
QAR	TANIEJE
RON	DROŻEJE
RUB	DROŻEJE
RWF	DROŻEJE
SVC	TANIEJE
WST	TANIEJE
STN	DROŻEJE
SAR	TANIEJE
RSD	DROŻEJE
SCR	TANIEJE
SLL	DROŻEJE
SGD	TANIEJE
SBD	DROŻEJE
SOS	DROŻEJE
ZAR	TANIEJE
KRW	DROŻEJE
SSP	TANIEJE
LKR	DROŻEJE
SDG	TANIEJE
SRD	TANIEJE
SZL	DROŻEJE
SEK	TANIEJE
SYP	DROŻEJE
TJS	TANIEJE
TZS	DROŻEJE
THB	TANIEJE
TOP	TANIEJE
TTD	DROŻEJE
TND	TANIEJE
TRY	DROŻEJE
AED	TANIEJE
UGX	DROŻEJE
UAH	TANIEJE
UYU	DROŻEJE
UZS	DROŻEJE
VUV	TANIEJE
VES	DROŻEJE
VND	DROŻEJE
XOF	TANIEJE
YER	TANIEJE
ZMW	TANIEJE

KURS DOLARA SPADŁ
W ciągu tygodnia najwięcej zyskał Singapore Dollar
W ciągu tygodnia najwięcej stracił Paraguayan GuaranĂ­
